33333333333333333333
31111112222221111113
31111112333321111113
32222222333222222223
32233333333333312223
32233333333333312223
32233333333333312223
32233333333333312223
32222222222222222213
31111113322331111113
31111112222221111113
33333333333333333330
