33333333222233333333
33311222222222211333
33311221111112211333
33311221133112211333
33311221133112211333
33311221133112211333
33111221133112211133
33111221133112211133
33311221111112211333
22222222222222222222
22222222222222222222
33331111222211113333
